0,0,0,17,1,17,1,1,1,18
0,0,0,9,0,0,1,17,1,17
0,0,0,0,0,9,0,1,1,1
8,8,8,0,0,0,0,9,0,17
8,8,0,0,0,0,0,16,16,8
24,0,0,0,0,0,8,0,16,16
24,0,8,0,8,8,0,0,0,8
24,0,0,0,8,8,8,0,0,0
24,16,9,0,0,0,0,0,0,0
16,0,8,0,0,0,8,0,16,0
